# Class Name

WH_Rover	KEYWORD1

# Method Names

runMotors	KEYWORD2
moveForward	KEYWORD2
moveBackward	KEYWORD2
turnLeft	KEYWORD2
turnRight	KEYWORD2
brakeToZero	KEYWORD2
moveUntil	KEYWORD2
executeWhile	KEYWORD2
stopMotors	KEYWORD2
stopAll	KEYWORD2
getODS	KEYWORD2
enableUS	KEYWORD2
disableUS	KEYWORD2
getUS	KEYWORD2
getIR	KEYWORD2

# Enumerations

ODSPin	KEYWORD1
ODS_L	KEYWORD3
ODS_R	KEYWORD3

USChannel	KEYWORD1
US_FL	KEYWORD3
US_FF	KEYWORD3
US_FR	KEYWORD3
US_BR	KEYWORD3
US_BB	KEYWORD3
US_BL	KEYWORD3

IRPin	KEYWORD1
IR_LF	KEYWORD3
IR_FL	KEYWORD3
IR_FR	KEYWORD3
IR_RF	KEYWORD3
IR_RB	KEYWORD3
IR_BR	KEYWORD3
IR_BL	KEYWORD3
IR_LB	KEYWORD3
